
WE  ../.././textures/apart.xpm


R          1200         800

EA   ../.././textures/paper.xpm

SO ../.././textures/bamboo.xpm

S ../.././textures/bed2.xpm

NO /Users/ahernand/A_42_School/cub3D/textures/wood.xpm

F     55, 122, 126

C  239, 201, 175

111111111111111
1000000000000111111111111111
100000000000000000000011111111111
100000N0000000011110000000000000111
10000000000000111111111111111000001111111
111111111111111111111111111110000000000011111
11111111111111111111111111111111111111111

