111111111
100000001
10N000001
100000001
100010001
100000001
100020001
 0000000
111111111
